{
  "1": {
    "player": [1, 3],
    "mummy": [[5, 5]],
    "key": null,
    "bom": null,
    "matrix": [
      [13, 3, 9, 1, 5, 5],
      [9, 4, 6, 10, 9, 3],
      [10, 9, 3, 8, 6, 10],
      [10, 10, 8, 0, 1, 2],
      [12, 6, 12, 2, 10, 10],
      [13, 5, 5, 4, 6, 14]
    ]
  },
   "2": {
    "player": [4, 3],
    "mummy": [[0, 0]],
    "key": null,
    "bom": null,
    "matrix": [
      [13, 1, 1, 3, 9, 1],
      [9, 4, 2, 10, 12, 2],
      [12, 3, 14, 12, 3, 10],
      [9, 0, 1, 5, 6, 10],
      [10, 10, 10, 9, 3, 10],
      [12, 4, 4, 6, 12, 6]
    ]
  },
  "3": {
    "player": [2, 5],
    "mummy": [[4, 0], [5, 2]],
    "key": null,
    "bom": null,
    "matrix": [
      [13, 1, 1, 0, 1, 3],
      [9, 2, 12, 4, 2, 14],
      [8, 4, 5, 3, 12, 3],
      [12, 1, 3, 8, 1, 2],
      [9, 4, 2, 12, 6, 10],
      [12, 5, 4, 5, 5, 6]
    ]
  },
  "4": {
    "player": [0, 0],
    "mummy": [[4, 2]],
    "key": [0, 2],
    "bom": [0, 4],
    "matrix": [
      [13, 1, 5, 4, 5, 3],
      [11, 8, 3, 9, 1, 2],
      [8, 2, 12, 6, 12, 2],
      [8, 4, 5, 3, 9, 2],
      [12, 3, 11, 12, 6, 10],
      [13, 4, 4, 5, 5, 6]
    ]
  },
  "5": {
    "player": [1, 2],
    "mummy": [[4, 4], [5, 3]],
    "key": [0, 1],
    "bom": [1, 0],
    "matrix": [
      [12, 1, 1, 5, 5, 3],
      [11, 10, 8, 5, 7, 10],
      [8, 0, 4, 5, 5, 2],
      [8, 4, 3, 9, 3, 10],
      [8, 5, 4, 2, 10, 10],
      [12, 5, 5, 4, 4, 6]
    ]
  },
  "6": {
    "player": [6, 0],
    "mummy": [[6, 7]],
    "key": null,
    "bom": null,
    "matrix": [
      [9, 3, 9, 1, 5, 1, 3, 11],
      [10, 8, 2, 12, 1, 6, 10, 10],        
      [2, 10, 8, 3, 12, 3, 12, 2],
      [8, 6, 8, 4, 3, 8, 3, 10],
      [12, 3, 12, 3, 8, 2, 10, 10],        
      [9, 4, 5, 6, 10, 10, 8, 6],
      [8, 1, 5, 5, 4, 0, 0, 3],
      [12, 6, 13, 5, 5, 4, 4, 6]
    ]
  },
  "7": {
    "player": [6, 4],
    "mummy": [[1, 5]],
    "key": null,
    "bom": null,
    "matrix": [
      [9, 1, 1, 1, 1, 5, 1, 3],
      [8, 2, 10, 12, 2, 11, 10, 14],       
      [8, 0, 2, 13, 4, 2, 12, 3],
      [10, 12, 4, 5, 5, 4, 3, 10],
      [0, 5, 5, 5, 1, 3, 8, 2],
      [8, 5, 5, 1, 0, 6, 10, 10],
      [8, 1, 1, 4, 0, 3, 8, 2],
      [14, 12, 4, 5, 6, 12, 4, 6]
    ]
  },
  "8": {
    "player": [6, 1],
    "mummy": [[2, 6], [1, 2]],
    "key": null,
    "bom": null,
    "matrix": [
      [9, 1, 1, 7, 9, 3, 9, 3],
      [10, 8, 4, 5, 2, 10, 8, 2],
      [10, 12, 5, 1, 2, 10, 10, 10],       
      [8, 1, 7, 10, 10, 12, 6, 10],        
      [10, 12, 3, 12, 2, 9, 1, 6],
      [12, 3, 12, 1, 2, 12, 0, 3],
      [3, 12, 3, 10, 8, 1, 0, 2],
      [12, 5, 4, 4, 6, 12, 4, 6]
    ]
  },
  "9": {
    "player": [4, 2],
    "mummy": [[5, 5]],
    "key": [4, 1],
    "bom": [4, 4],
    "matrix": [
      [9, 3, 9, 1, 1, 5, 5, 3],
      [10, 10, 8, 0, 4, 1, 5, 2],
      [10, 10, 10, 8, 5, 4, 3, 10],        
      [10, 10, 12, 0, 3, 9, 4, 6],
      [8, 2, 9, 4, 2, 10, 9, 3],
      [10, 8, 6, 9, 6, 12, 2, 10],
      [10, 12, 3, 8, 1, 7, 10, 10],        
      [4, 5, 6, 14, 12, 5, 4, 6]
    ]
  },
  "10": {
    "player": [3, 6],
    "mummy": [[6, 2], [0, 2]],
    "key": [6, 7],
    "bom": [5, 2],
    "matrix": [
      [11, 9, 3, 9, 1, 1, 1, 3],
      [8, 6, 10, 14, 8, 0, 4, 2],
      [12, 3, 12, 5, 6, 8, 5, 2],
      [9, 0, 5, 5, 1, 6, 13, 2],
      [10, 14, 9, 1, 2, 9, 3, 10],
      [10, 9, 2, 10, 12, 6, 12, 2],        
      [8, 2, 10, 12, 3, 9, 1, 2],
      [12, 4, 4, 5, 4, 6, 8, 6]
    ]
  },
  "11": {
    "player": [5, 4],
    "mummy": [[0, 0]],
    "key": null,
    "bom": null,
    "matrix": [
      [13, 3, 9, 5, 5, 3, 11, 9, 5, 3],
      [9, 4, 2, 9, 5, 6, 12, 6, 9, 2],
      [8, 3, 10, 8, 5, 1, 1, 5, 4, 2],
      [8, 4, 2, 12, 3, 10, 12, 1, 1, 6],
      [12, 5, 6, 9, 4, 4, 3, 10, 10, 11],
      [9, 5, 3, 10, 9, 3, 10, 10, 8, 2],
      [10, 9, 4, 6, 10, 8, 6, 10, 12, 2],
      [8, 0, 1, 5, 4, 4, 1, 0, 3, 10],
      [12, 0, 6, 9, 5, 3, 14, 8, 4, 2],
      [5, 4, 5, 6, 13, 4, 5, 6, 13, 6]
    ]
  },
   "12": {
    "player": [9, 2],
    "mummy": [[2, 6]],
    "key": null,
    "bom": null,
    "matrix": [
      [11, 9, 7, 9, 1, 5, 5, 3, 13, 3],    
      [8, 0, 3, 8, 2, 9, 7, 10, 9, 2],     
      [10, 10, 12, 2, 10, 8, 5, 4, 2, 10], 
      [2, 8, 3, 12, 2, 10, 13, 1, 0, 6],   
      [10, 10, 10, 9, 2, 12, 5, 2, 12, 3], 
      [8, 2, 12, 4, 4, 1, 3, 12, 5, 2],    
      [10, 12, 5, 1, 5, 4, 2, 9, 1, 6],    
      [12, 5, 3, 12, 5, 3, 10, 10, 8, 3],  
      [9, 3, 12, 3, 9, 2, 10, 12, 2, 10],  
      [14, 12, 5, 4, 6, 12, 4, 5, 4, 6]    
    ]
  },
  "13": {
    "player": [7, 6],
    "mummy": [[3, 7], [2, 7]],
    "key": null,
    "bom": null,
    "matrix": [
      [13, 5, 5, 1, 1, 7, 9, 1, 5, 3],
      [9, 3, 9, 0, 4, 5, 2, 8, 5, 2],
      [10, 8, 2, 8, 5, 1, 2, 12, 3, 10],
      [8, 2, 8, 4, 3, 10, 8, 1, 2, 14],
      [4, 2, 8, 3, 12, 6, 8, 4, 4, 3],
      [9, 2, 10, 10, 9, 3, 12, 5, 3, 10],
      [8, 4, 2, 8, 2, 12, 5, 3, 10, 10],
      [12, 1, 2, 12, 2, 9, 3, 10, 14, 10],
      [9, 6, 12, 1, 0, 2, 10, 10, 9, 2],
      [12, 5, 5, 4, 4, 6, 12, 4, 6, 14]    
    ]
  },
  "14": {
    "player": [2, 9],
    "mummy": [[4, 0]],
    "key": [9, 6],
    "bom": [1, 4],
    "matrix": [
      [11, 13, 1, 1, 3, 9, 5, 1, 5, 3],    
      [12, 5, 0, 6, 8, 2, 9, 2, 13, 2],    
      [9, 3, 8, 5, 4, 0, 6, 12, 1, 2],     
      [10, 12, 2, 9, 3, 12, 1, 7, 12, 2],  
      [8, 3, 12, 2, 8, 3, 10, 9, 5, 2],    
      [10, 12, 1, 2, 8, 6, 10, 8, 5, 2],   
      [8, 3, 8, 4, 6, 9, 6, 10, 9, 2],     
      [10, 10, 10, 13, 5, 0, 5, 6, 10, 14],
      [10, 12, 0, 3, 9, 4, 5, 1, 4, 3],    
      [12, 5, 4, 4, 6, 13, 5, 0, 5, 6]     
    ]
  },
  "15": {
    "player": [6, 5],
    "mummy": [[0, 7], [3, 5]],
    "key": [8, 9],
    "bom": [2, 7],
    "matrix": [
      [9, 1, 1, 3, 9, 1, 5, 1, 1, 3],      
      [12, 6, 10, 8, 2, 12, 3, 10, 10, 10],
      [9, 1, 2, 10, 12, 3, 10, 12, 4, 2],  
      [10, 10, 14, 12, 5, 6, 10, 9, 5, 2], 
      [10, 12, 5, 1, 1, 7, 10, 10, 9, 6],  
      [8, 5, 5, 2, 12, 3, 12, 6, 12, 3],   
      [12, 5, 3, 8, 1, 4, 5, 1, 5, 6],     
      [13, 3, 10, 10, 8, 3, 13, 0, 5, 3],  
      [9, 6, 8, 4, 2, 12, 1, 2, 9, 6],     
      [12, 5, 4, 5, 6, 13, 4, 6, 8, 7]     
    ]
  },
  "16": {
    "player": [9, 2],
    "mummy": [[0, 5], [5, 0]],
    "key": [9, 5],
    "bom": [5, 6],
    "matrix": [
      [13, 5, 5, 1, 1, 5, 1, 1, 5, 7],     
      [9, 3, 9, 2, 10, 9, 0, 0, 5, 3],     
      [10, 12, 4, 0, 0, 2, 12, 4, 3, 10],  
      [8, 1, 3, 8, 4, 4, 5, 1, 6, 10],     
      [8, 2, 14, 8, 5, 5, 1, 4, 3, 10],    
      [10, 8, 1, 2, 9, 5, 4, 5, 6, 10],    
      [8, 0, 4, 0, 2, 9, 1, 3, 9, 2],      
      [12, 4, 3, 12, 4, 6, 10, 10, 10, 10],
      [9, 5, 6, 9, 5, 3, 8, 2, 8, 2],      
      [12, 5, 5, 6, 13, 4, 4, 4, 2, 14]    
    ]
  },
  "17": {
    "player": [7, 2],
    "mummy": [[8, 6], [4, 7]],
    "key": [1, 5],
    "bom": [0, 4],
    "matrix": [
      [11, 9, 1, 1, 7, 9, 4, 3, 9, 3],
      [10, 14, 10, 14, 9, 6, 11, 12, 4, 2],      
      [8, 1, 0, 3, 10, 9, 4, 1, 3, 10],
      [10, 10, 12, 4, 2, 10, 9, 4, 4, 2],        
      [10, 12, 5, 3, 10, 10, 10, 13, 3, 10],     
      [8, 3, 9, 6, 8, 6, 8, 3, 10, 10],
      [12, 2, 10, 13, 0, 3, 8, 6, 10, 10],       
      [9, 6, 12, 5, 4, 4, 6, 9, 0, 6],
      [8, 1, 3, 9, 3, 9, 5, 6, 12, 3],
      [12, 6, 12, 6, 12, 4, 5, 5, 5, 6]
    ]
  },
  "18": {
    "player": [2, 2],
    "mummy": [[6, 7], [0, 8]],
    "key": [6, 0],
    "bom": [4, 7],
    "matrix": [
      [9, 3, 9, 1, 1, 7, 9, 1, 5, 3],
      [10, 12, 0, 2, 12, 5, 4, 0, 1, 2],
      [8, 3, 8, 4, 5, 3, 9, 2, 8, 2],
      [8, 2, 8, 5, 3, 12, 6, 10, 8, 6],
      [10, 12, 2, 9, 4, 5, 3, 8, 0, 3],
      [12, 1, 6, 8, 1, 7, 10, 8, 4, 2],
      [9, 4, 5, 2, 10, 9, 2, 10, 13, 2],
      [10, 9, 1, 4, 6, 12, 2, 8, 3, 10],
      [4, 0, 4, 5, 1, 5, 2, 8, 4, 2],
      [13, 4, 5, 5, 4, 5, 4, 6, 13, 6]
    ]
  },
  "19": {
    "player": [5, 4],
    "mummy": [[3, 1], [0, 9]],
    "key": [9, 3],
    "bom": [4, 4],
    "matrix": [
      [11, 9, 3, 9, 5, 1, 1, 1, 5, 3],
      [10, 10, 10, 10, 11, 8, 4, 6, 9, 6],       
      [8, 0, 2, 12, 0, 2, 9, 7, 8, 3],
      [12, 6, 12, 5, 4, 4, 0, 5, 4, 6],
      [9, 3, 9, 1, 1, 1, 4, 3, 9, 3],
      [10, 12, 0, 0, 2, 8, 1, 4, 6, 10],
      [8, 3, 8, 0, 0, 6, 8, 3, 9, 6],
      [10, 8, 4, 4, 2, 9, 6, 10, 12, 3],
      [10, 8, 1, 7, 10, 12, 3, 8, 5, 2],
      [4, 4, 4, 5, 4, 5, 6, 12, 5, 6]
    ]
  },
  "20": {
    "player": [5, 8],
    "mummy": [[7, 4], [9, 9]],
    "key": [0, 7],
    "bom": [1, 2],
    "matrix": [
      [11, 9, 1, 3, 13, 5, 0, 3, 9, 3],
      [10, 12, 2, 12, 1, 3, 10, 12, 0, 2],       
      [10, 9, 6, 9, 4, 4, 6, 11, 10, 10],        
      [12, 6, 9, 0, 1, 5, 1, 2, 8, 2],
      [9, 5, 4, 0, 4, 1, 6, 12, 2, 10],
      [8, 3, 9, 6, 13, 0, 3, 11, 12, 6],
      [14, 10, 12, 5, 1, 6, 10, 12, 5, 3],       
      [9, 4, 1, 5, 4, 5, 0, 1, 5, 2],
      [8, 3, 12, 1, 5, 1, 4, 6, 9, 6],
      [14, 12, 5, 4, 7, 12, 5, 5, 4, 7]
    ]
  }
}